1111111111
1E000001C1
1111100101
100C000101
1001100101
1000000101
1000011101
1000010P01
1000000001
1111111111