1111111111
10000001C1
1111100101
100C000101
1001100101
1000000101
1000011101
1000010P01
1000000001
1011100001
10C010C001
100C100001
1000000E01
1111111111