111111
10E001
1P0001
100C01
111111