111111
10E001
1P0001
1000C1
111111