1111111111111111111111111111111111111111111111111111111111111111111
100P00000EC0000000000000000000000C000000000000000000000C00000000001
1111111111111111111111111111111111111111111111111111111111111111111